"","InDegree","OutDegree","AllDegree","InStrength","OutStrength","AllStrength"
"Adam Pinkman",2,1,3,17,4,21
"Clovis",1,1,2,32,14,46
"Henry Tyree",3,1,4,17,1,18
"Jesse Pinkman",8,9,17,142,167,309
"Louis Corbett",2,1,3,9,8,17
"Mr. Gardiner",1,3,4,11,13,24
"Mrs. Pinkman",2,1,3,46,22,68
"Paul Tyree",3,3,6,26,43,69
"Sara Tyree",2,3,5,7,5,12
"Skyler White",2,2,4,131,52,183
"Walter White",5,5,10,127,324,451
"Walter White Jr.",3,4,7,131,39,170
"Wino",1,1,2,1,5,6
